curr_date,last_clean_date,last_people_traffic,last_inspection_score,prev_last_clean_date,prev_people_traffic,prev_inspection_score,time_between_cleaning,people_traffic_diff,target_time_between_cleaning
2024-04-05,2024-04-04 21:00:00,1,96,2024-04-04 17:00:00,13,98,4.0,-12,5.0
2024-04-05,2024-04-04 22:00:00,15,97,2024-04-04 18:00:00,23,85,4.0,-8,4.0
2024-04-05,2024-04-04 23:00:00,16,97,2024-04-04 19:00:00,25,93,4.0,-9,4.0
2024-04-05,2024-04-04 13:00:00,9,99,2024-04-04 09:00:00,25,90,4.0,-16,5.0
2024-04-05,2024-04-04 05:00:00,21,96,2024-04-04 01:00:00,11,95,4.0,10,4.0
2024-04-05,2024-04-04 09:00:00,16,93,2024-04-04 05:00:00,1,85,4.0,15,4.0
2024-04-05,2024-04-04 21:00:00,9,100,2024-04-04 17:00:00,7,85,4.0,2,5.0
2024-04-05,2024-04-04 03:00:00,26,99,2024-04-03 23:00:00,3,98,4.0,23,4.0
2024-04-05,2024-04-04 01:00:00,30,86,2024-04-03 21:00:00,21,96,4.0,9,3.0
2024-04-05,2024-04-04 07:00:00,15,98,2024-04-04 03:00:00,3,96,4.0,12,4.0
