last_people_traffic,last_inspection_score,prev_people_traffic,prev_inspection_score,time_between_cleaning,people_traffic_diff,target_time_between_cleaning
1,96,13,98,4.0,-12,5.0
15,97,23,85,4.0,-8,4.0
16,97,25,93,4.0,-9,4.0
9,99,25,90,4.0,-16,5.0
21,96,11,95,4.0,10,4.0
16,93,1,85,4.0,15,4.0
9,100,7,85,4.0,2,5.0
26,99,3,98,4.0,23,4.0
30,86,21,96,4.0,9,3.0
15,98,3,96,4.0,12,4.0
